,groups1001Case,groups1401Case,groups1601Case,groups901Case,groups902Control,groupsBXS0110Control,groupsBXS0111Control,groupsBXS0114Control,groupsBXS0115Control,groupsBXS0116Control,groupsBXS0117Control,groupsBYS0112Control,groupsGM23716Control,groupsGM23720Control,groupsGM25256Control,groupsPGP1Control
1,0,0,0,0,0,0,0,0,0,0,0,0,0,0,0,1
2,0,0,0,0,0,0,0,0,0,0,0,0,0,0,0,1
3,0,0,0,0,0,0,0,0,0,0,0,0,0,0,0,1
4,0,0,0,0,0,0,0,0,0,0,0,0,1,0,0,0
5,0,0,0,0,0,0,0,0,0,0,0,0,1,0,0,0
6,0,0,0,0,0,0,0,0,0,0,0,0,1,0,0,0
7,0,0,0,0,0,0,0,0,0,0,0,0,0,1,0,0
8,0,0,0,0,0,0,0,0,0,0,0,0,0,1,0,0
9,0,0,0,0,0,0,0,0,0,0,0,0,0,1,0,0
10,0,0,0,0,0,0,0,0,0,0,0,0,0,0,1,0
11,0,0,0,0,0,0,0,0,0,0,0,0,0,0,1,0
12,0,0,0,0,0,0,0,0,0,0,0,0,0,0,1,0
13,0,0,0,0,0,1,0,0,0,0,0,0,0,0,0,0
14,0,0,0,0,0,1,0,0,0,0,0,0,0,0,0,0
15,0,0,0,0,0,1,0,0,0,0,0,0,0,0,0,0
16,0,0,0,0,0,0,1,0,0,0,0,0,0,0,0,0
17,0,0,0,0,0,0,1,0,0,0,0,0,0,0,0,0
18,0,0,0,0,0,0,1,0,0,0,0,0,0,0,0,0
19,0,0,0,0,0,0,0,0,0,0,0,1,0,0,0,0
20,0,0,0,0,0,0,0,0,0,0,0,1,0,0,0,0
21,0,0,0,0,0,0,0,0,0,0,0,1,0,0,0,0
22,0,0,0,0,0,0,0,1,0,0,0,0,0,0,0,0
23,0,0,0,0,0,0,0,1,0,0,0,0,0,0,0,0
24,0,0,0,0,0,0,0,1,0,0,0,0,0,0,0,0
25,0,0,0,0,0,0,0,0,1,0,0,0,0,0,0,0
26,0,0,0,0,0,0,0,0,1,0,0,0,0,0,0,0
27,0,0,0,0,0,0,0,0,1,0,0,0,0,0,0,0
28,0,0,0,0,0,0,0,0,0,1,0,0,0,0,0,0
29,0,0,0,0,0,0,0,0,0,1,0,0,0,0,0,0
30,0,0,0,0,0,0,0,0,0,1,0,0,0,0,0,0
31,0,0,0,0,0,0,0,0,0,0,1,0,0,0,0,0
32,0,0,0,0,0,0,0,0,0,0,1,0,0,0,0,0
33,0,0,0,0,0,0,0,0,0,0,1,0,0,0,0,0
34,0,0,0,0,1,0,0,0,0,0,0,0,0,0,0,0
35,0,0,0,0,1,0,0,0,0,0,0,0,0,0,0,0
36,0,0,0,0,1,0,0,0,0,0,0,0,0,0,0,0
37,0,0,1,0,0,0,0,0,0,0,0,0,0,0,0,0
38,0,0,1,0,0,0,0,0,0,0,0,0,0,0,0,0
39,0,0,1,0,0,0,0,0,0,0,0,0,0,0,0,0
40,0,1,0,0,0,0,0,0,0,0,0,0,0,0,0,0
41,0,1,0,0,0,0,0,0,0,0,0,0,0,0,0,0
42,0,1,0,0,0,0,0,0,0,0,0,0,0,0,0,0
43,1,0,0,0,0,0,0,0,0,0,0,0,0,0,0,0
44,1,0,0,0,0,0,0,0,0,0,0,0,0,0,0,0
45,1,0,0,0,0,0,0,0,0,0,0,0,0,0,0,0
46,0,0,0,1,0,0,0,0,0,0,0,0,0,0,0,0
47,0,0,0,1,0,0,0,0,0,0,0,0,0,0,0,0
48,0,0,0,1,0,0,0,0,0,0,0,0,0,0,0,0
